%%%%%%%%%%%%%%%%%%%%
%o....%%....%%....o%
%.....%......%.%%%.%
%.....% %%%% %.....%
%.%%% %        %%%.% 
%.....%%%G  G%%%...%
%.%%%.%......%.%%%.%
%......%%%%%%......%
%.%%.%     P   %.%%%
%%%%%%%%%%%%%%%%%%%%
